1111111111111
1000000000001
10CCCCP000001
11C1111100011
1000010000001
10E0010100111
1000010001111
1111111111111
