111111111111
000000000001
100CPE000001
111111111111