1111111111
1C10EP0001
1111111111