111111111111
10CPE0000001


100000000001
111111111111