1111111111111
100000PE00001
1111111111111