1111111111111
100cpe0000001
1111111111111